{
  "name": "Level 1",
  "width": 30,
  "height": 20,
  "tiles": [
    17, 24, 24, 24, 24, 24, 24, 24, 24, 24,
    24, 24, 24, 24, 24, 24, 24, 24, 24, 24,
    24, 24, 24, 24, 24, 24, 24, 24, 24, 18,
    14, 0, 0, 0, 0, 0, 0, 0, 0, 0,
    0, 0, 0, 0, 0, 0, 0, 0, 0, 0,
    0, 0, 0, 0, 0, 0, 0, 0, 0, 12,
    14, 0, 0, 0, 0, 0, 0, 0, 0, 0,
    0, 0, 0, 0, 0, 0, 0, 0, 0, 0,
    0, 0, 0, 0, 0, 0, 0, 0, 0, 12,
    14, 0, 0, 0, 0, 0, 0, 0, 0, 0,
    0, 0, 0, 0, 0, 0, 0, 0, 0, 4,
    0, 0, 0, 0, 0, 0, 0, 0, 0, 12,
    14, 0, 0, 0, 0, 0, 0, 0, 0, 34,
    35, 36, 0, 0, 0, 34, 35, 36, 0, 15,
    0, 0, 0, 0, 0, 0, 0, 0, 0, 12,
    14, 0, 0, 0, 0, 0, 0, 0, 0, 0,
    0, 0, 0, 0, 0, 0, 0, 0, 0, 38,
    35, 36, 0, 0, 0, 0, 0, 0, 0, 12,
    14, 0, 0, 0, 0, 0, 0, 0, 0, 0,
    0, 0, 0, 0, 0, 0, 0, 0, 0, 0,
    0, 0, 4, 0, 0, 0, 0, 0, 0, 12,
    14, 0, 0, 0, 0, 0, 0, 0, 0, 0,
    0, 0, 0, 0, 0, 0, 0, 0, 0, 0,
    0, 0, 15, 0, 0, 0, 0, 0, 0, 12,
    14, 0, 0, 0, 0, 0, 0, 0, 0, 0,
    0, 0, 0, 0, 0, 0, 0, 0, 0, 0,
    0, 0, 26, 0, 0, 0, 0, 0, 0, 12,
    14, 34, 35, 36, 0, 0, 0, 0, 0, 0,
    0, 0, 0, 0, 0, 0, 0, 0, 0, 0,
    0, 0, 0, 0, 0, 34, 35, 36, 0, 12,
    14, 0, 0, 0, 0, 0, 0, 0, 0, 0,
    0, 0, 0, 0, 0, 1, 2, 3, 0, 0,
    0, 0, 0, 0, 0, 0, 0, 0, 0, 12,
    14, 0, 0, 0, 0, 0, 0, 0, 0, 0,
    0, 0, 0, 0, 0, 12, 13, 14, 0, 0,
    0, 0, 0, 0, 0, 0, 0, 0, 0, 12,
    14, 0, 0, 0, 0, 1, 2, 2, 2, 2,
    2, 2, 2, 2, 2, 29, 13, 28, 2, 2,
    2, 2, 2, 3, 0, 0, 0, 0, 0, 12,
    14, 0, 0, 0, 0, 12, 13, 13, 13, 13,
    13, 13, 13, 13, 13, 13, 13, 13, 13, 13,
    13, 13, 13, 14, 0, 0, 0, 0, 0, 12,
    14, 0, 0, 0, 0, 12, 13, 13, 13, 13,
    13, 13, 13, 13, 13, 13, 13, 13, 13, 13,
    13, 13, 13, 14, 0, 0, 0, 0, 0, 12,
    14, 0, 0, 0, 0, 23, 24, 24, 24, 24,
    24, 24, 24, 24, 24, 24, 24, 24, 24, 24,
    24, 24, 24, 25, 0, 0, 0, 0, 0, 12,
    14, 0, 0, 0, 0, 0, 0, 0, 0, 0,
    0, 0, 0, 0, 0, 0, 0, 0, 0, 0,
    0, 0, 0, 0, 0, 0, 0, 0, 0, 12,
    14, 0, 0, 0, 0, 0, 0, 0, 0, 0,
    0, 0, 0, 0, 0, 0, 0, 0, 0, 0,
    0, 0, 0, 0, 0, 0, 0, 0, 0, 12,
    14, 0, 0, 0, 0, 0, 0, 0, 0, 0,
    0, 0, 0, 0, 0, 0, 0, 0, 0, 0,
    0, 0, 0, 0, 0, 0, 0, 0, 0, 12,
    14, 0, 0, 0, 0, 0, 0, 0, 0, 0,
    0, 0, 0, 0, 0, 0, 0, 0, 0, 0,
    0, 0, 0, 0, 0, 0, 0, 0, 0, 12
  ],
  "playerX": 80,
  "playerY": 96,
  "solids": [
    [0, 0, 480, 16],
    [0, 16, 16, 304],
    [464, 16, 16, 304],
    [16, 144, 48, 16],
    [144, 64, 48, 16],
    [240, 64, 48, 16],
    [304, 80, 48, 16],
    [304, 48, 16, 32],
    [352, 96, 16, 48],
    [400, 144, 48, 16],
    [80, 192, 304, 64],
    [240, 160, 48, 32]
  ],
  "items": [
    { "type": "fruit", "x": 160, "y": 176 },
    { "type": "fruit", "x": 200, "y": 160 },
    { "type": "fruit", "x": 240, "y": 144 },
    { "type": "fruit", "x": 160, "y": 144 },
    { "type": "fruit", "x": 96, "y": 32 },
    { "type": "fruit", "x": 32, "y": 112 }
  ]
}
